1335 HaXx0r	10 adventures
Alphabet Giant	10 adventures
Battlie Knight Ghost	7 adventures
Bob Racecar	10 adventures
Booze Giant	7 adventures
CH imp	7 adventures
Cloud of disembodied whiskers	7 adventures
G imp	5 adventures
Grass Elemental	7 adventures
Iiti Kitty	10 adventures
Irritating Series of Random Encounters	10 adventures
Knob Goblin Bean Counter	5 adventures
Knob Goblin Madam	5 adventures
Knob Goblin Master Chef	5 adventures
Knob Goblin Very Mad Scientist	7 adventures
L imp	5 adventures
Little man in the canoe	10 adventures
Mob Penguin Capo	10 adventures
Ninja Snowman Janitor	7 adventures
One-Eyed Willie	10 adventures
P imp	5 adventures
Racecar Bob	10 adventures
Raver Giant	10 adventures
Renaissance Giant	10 adventures
W imp	5 adventures
albino bat	5 adventures
animated rustic nightstand	7 adventures
basic lihc	7 adventures
batrat	5 adventures
black magic woman	10 adventures
blur	10 adventures
bubblemint twins	7 adventures
chalkdust wraith	7 adventures
coaltergeist	10 adventures
dire pigeon	5 adventures
eXtreme Orcish snowboarder	7 adventures
fleet woodsman	10 adventures
gingerbread murderer	5 adventures
gluttonous ghuol	7 adventures
grave rober	5 adventures
grave rober zmobie	7 adventures
guy with a pitchfork, and his wife	7 adventures
irate mariachi	5 adventures
junksprite sharpener	7 adventures
mad wino	10 adventures
magical fruit bat	5 adventures
model skeleton	7 adventures
oil baron	7 adventures
party skelteon	7 adventures
plastered frat orc	5 adventures
possessed silverware drawer	7 adventures
possessed toy chest	7 adventures
pygmy blowgunner	10 adventures
pygmy headhunter	10 adventures
pygmy orderlies	10 adventures
pygmy shaman	10 adventures
revolving bugbear	7 adventures
sabre-toothed goat	7 adventures
serialbus	7 adventures
sheet ghost	7 adventures
skeletal hamster	7 adventures
smut orc pipelayer	7 adventures
swarm of Knob lice	5 adventures
swarm of fire ants	10 adventures
swarm of killer bees	7 adventures
swarm of skulls	5 adventures
tapdancing skeleton	7 adventures
toilet papergeist	7 adventures
tomb asp	10 adventures
upgraded ram	7 adventures
vicious gnauga	7 adventures
warwelf	5 adventures
whitesnake	7 adventures

Astronomer	Innuendo Circuitry
BASIC Elemental	Basic Improvements
Big Wheelin' Twins	Overclocking
Boss Bat	Grey Noise
Bullet Bill	Reloading
Claybender Sorcerer Ghost	Ectogenesis
Cobb's Knob oven	Microburner
Flock of Stab-bats	AUTOEXEC.BAT
Knob Goblin Alchemist	Solid Fuel
Knob Goblin Elite Guard	Advanced Exo-Alloy
Knob Goblin Harem Girl	Camp Subroutines
Knob Goblin MBA	Cryocurrency
Ninja Snowman Weaponmaster	Cooling Tubules
Pr Imp	Temporal Hyperextension
Pygmy Witch Lawyer	Infinite Loop
Shifty pirate	Shifted About
Spectral Jellyfish	Phase Shift
Steam Elemental	Steam Mycelia
Sub-Assistant Knob Mad Scientist	Provably Efficient
anglerbush	Ponzi Apparatus
animated ornate nightstand	Ominous Substrate
banshee librarian	Self-Actualized
baseball bat	Extra Innings
beanbat	Exhaust Tubules
black panther	Photonic Shroud
crÃªep	Telekinetic Murder
cubist bull	Localized Vacuum
demonic icebox	Infernal Automata
dopey 7-Foot Dwarf	Seven Foot Feelings
drunk goat	Secondary Fermentation
drunk pygmy	Double Nanovision
eXtreme cross-country hippy	Microweave
fan dancer	Subatomic Tango
ghost miner	Spooky Veins
jacob's adder	Nanoshock
junksprite bender	Propagation Drive
lihc	Curses Library
malevolent hair clog	Clammy Microcilia
me4t begZ0r	Financial Spreadsheets
mind flayer	Hivemindedness
oil slick	Lubricant Layer
pine bat	Conifer Polymers
pooltergeist	Subatomic Hardening
possessed wine rack	Legacy Code
pygmy janitor	System Sweep
raging bull	Ire Proof
ratbat	Nanofur
remaindered skeleton	Hardslab
rushing bum	Harried
sewer snake with a sewer snake in it	Snakesmack
smut orc screwer	Procgen Ribaldry
snow queen	Snow-Cooling System
spooky music box	Audioclasm
spooky vampire	Autovampirism Routines
stuffed moose head	Nantlers
suckubus	Gravitational Compression
undead elbow macaroni	Temporal Bent
werecougar	Anti-Sleaze Recursion
white lion	Piezoelectric Honk
zombie waltzers	Autochrony

Blue Oyster cultist	10 mysticality
Burly Sidekick	5 muscle
Carnivorous Moxie Weed	Fluid Dynamics Simulation
Fallen Archfiend	10 muscle
Fitness Giant	10 muscle
Gnefarious gnome	10 moxie
Hellion	10 mysticality
Knob Goblin Mutant	5 muscle
Possibility Giant	10 mysticality
Punk Rock Giant	10 moxie
Quiet Healer	5 mysticality
angry bugbear	10 muscle
baa-relief sheep	3 mysticality
bookbat	10 mysticality
craven carven raven	3 moxie
demoninja	10 moxie
drunken half-orc hobo	5 moxie
fiendish can of asparagus	5 mysticality
forest spirit	10 mysticality
gaunt ghuol	10 moxie
hung-over half-orc hobo	5 moxie
sassy pirate	5 moxie
senile lihc	10 mysticality
sleeping Knob Goblin Guard	5 muscle
spunky princess	5 moxie
stone temple pirate	3 muscle
swarm of scarab beatles	10 moxie
tomb servant	10 muscle
tomb servant	10 mysticality
toothy sklelton	10 muscle

Zol	5 maximum mp
fluffy bunny	5 maximum hp
beefy bodyguard bat	10 maximum hp
grumpy 7-Foot Dwarf	10 maximum mp
vampire bat	10 maximum hp
corpulent zobmie	20 maximum hp
plaque of locusts	20 maximum mp